############
##   #     #
##   # ..  #
##$$$ #..###
# $    @####
#   #   ####
############

############
##   #  $ .#
## $ #  .  #
##  $ #. ###
# $    @####
# . #   ####
############

############
##.  #  .  #
##   #     #
##$$$ # .###
# $    @####
#.  #   ####
############

############
##   #     #
##   # ..  #
##$ $ # .###
# $    @####
#   #   ####
############

############
##   #    .#
## $ #     #
##  $ #. ###
# $    @####
# . #   ####
############

############
##.  #  .  #
##   #     #
## $$ #  ###
# $    @####
#.  #   ####
############

############
##   #     #
##   # ..  #
##$ $ #  ###
#      @####
#   #   ####
############

############
##   #    .#
##   #     #
##  $ #. ###
# $    @####
#   #   ####
############

############
##.  #  .  #
##   #     #
##  $ #  ###
# $    @####
#   #   ####
############

############
##   #     #
##   #  .  #
##  $ #  ###
#      @####
#   #   ####
############

############
##   #    .#
##   #     #
##    #  ###
# $    @####
#   #   ####
############

############
##.  #     #
##   #     #
##  $ #  ###
#      @####
#   #   ####
############

